sys/main.dol:
  2149764984: [125, 164, 107, 120, 56, 132, 145, 64, 56, 0, 0, 30, 124, 9, 3, 166,
    128, 100, 0, 0, 136, 3, 0, 12, 44, 0, 0, 0, 65, 130, 1, 224, 56, 132, 0, 4, 66,
    0, 255, 236, 128, 109, 136, 136, 128, 3, 0, 0, 44, 0, 0, 0, 64, 130, 1, 200, 60,
    96, 128, 60, 56, 99, 76, 8, 168, 131, 0, 0, 44, 4, 0, 0, 64, 130, 1, 180, 60,
    96, 128, 59, 56, 99, 57, 160, 75, 222, 192, 13, 56, 96, 0, 0, 60, 128, 128, 59,
    56, 132, 57, 160, 56, 160, 0, 0, 75, 227, 26, 69, 60, 96, 128, 60, 56, 99, 76,
    8, 168, 131, 0, 0, 44, 4, 0, 0, 64, 130, 0, 8, 75, 227, 6, 13, 127, 227, 251,
    120, 56, 128, 0, 7, 75, 226, 97, 165, 72, 0, 1, 108, 0, 0, 0, 0, 0, 0, 0, 0]
  2147824084: [60, 96, 128, 35, 56, 99, 208, 12, 96, 0, 0, 0]
  2147824272: [56, 128, 0, 7]
  2149765132: [115, 101, 97, 0]
  2147824099: [0]
  2147824103: [44]
  2147824107: [255]
